##############
              
##  ##### ####
        Y     
##  ## ## ####
              
###  #########
###  #########