############################################
                                            
 #  ##### ###  #######     ####   ####   ## 
        Y  #  #         #  ####  #####   ## 
#  ## ## # #  #  ##                 #       
       #            ##############  ########
# #  # # # # #  #                     #     
             #  #  ## #    ########     ####
 #  ## # ### ####  ## #   ############      
       #                                    
##  #### ########  ## # #####  ##  ###  ####
                                            
  ##   ####        ########               ##
